@#####################
@#...................#
@#.???????.?.???????.#
@#.?.....?.?.?.....?.#
@#.?.???.?.?.?.???.?.#
@#...?.?.......?.?...#
@#.?.?.?.?.?.?.?.?.?.#
@#.?.....?.?.?.....?.#
@#.???????.?.???????.#
@###...............###
@Ttt.?.?.?.?.?.?.?.ttT
@###...............###
@#.???????.?.???????.#
@#.?.....?.?.?.....?.#
@#.?.?.?.?.?.?.?.?.?.#
@#...?.?.......?.?...#
@#.?.???.?.?.?.???.?.#
@#.?.....?.?.?.....?.#
@#.???????.?.???????.#
@#...................#
@#####################
